35 20
1700 1190
5 4 4 4 4 4 4 4 4 4 4 4 4 4 4 4 4 4 4 5 4 4 4 4 4 4 4 4 4 4 4 4 4 4 5
5 0 0 0 1 0 0 0 0 0 0 0 0 0 0 0 0 1 1 5 1 0 0 2 2 0 0 0 0 0 0 0 0 0 5
5 0 0 0 1 0 3 3 0 0 5 4 4 4 4 5 1 1 1 5 1 0 1 1 1 0 0 0 3 3 3 0 0 0 5
5 0 0 2 1 0 3 3 0 2 5 6 6 6 6 5 1 1 0 5 0 0 0 5 4 4 4 4 4 5 4 4 5 0 5
5 0 0 1 1 0 0 0 0 0 5 4 4 4 4 5 0 0 0 5 1 1 1 5 6 6 6 6 6 5 6 6 5 0 5
5 0 0 1 0 0 0 0 0 0 5 6 6 6 6 5 0 0 0 5 1 1 1 5 6 6 6 6 6 4 6 6 5 0 5
5 0 1 1 0 0 0 0 1 1 4 4 6 4 4 4 0 0 0 5 1 1 1 5 6 6 6 6 6 6 6 6 5 0 5
5 0 0 0 0 0 0 0 1 1 1 0 0 0 0 0 2 0 0 5 1 1 2 5 6 6 6 6 6 5 6 6 5 0 5
5 0 0 0 5 4 4 4 5 1 1 0 0 0 0 0 0 0 0 5 1 1 2 5 6 6 6 6 6 5 6 6 5 0 5
5 0 0 0 5 6 6 6 5 0 0 0 0 0 0 3 3 3 0 5 1 1 1 5 6 6 6 6 6 5 6 6 5 0 5
5 2 2 2 5 6 6 6 5 0 0 0 2 0 0 3 3 3 0 5 0 0 1 4 4 4 6 4 4 4 4 4 4 0 5
5 0 2 2 5 6 6 6 5 0 0 2 1 2 0 3 3 3 0 5 0 0 1 1 1 1 1 1 1 1 1 0 0 0 5
5 0 0 2 5 6 6 6 5 0 0 0 2 0 0 0 0 0 0 5 0 0 0 0 0 0 0 0 0 0 0 0 0 0 5
5 0 0 2 4 4 6 4 4 2 0 0 0 0 0 4 4 4 4 5 0 0 0 0 0 0 3 3 3 0 0 0 0 0 5
5 0 0 0 0 3 3 3 0 1 1 0 0 0 0 6 6 6 6 5 0 0 0 0 0 0 3 3 3 0 0 0 0 0 5
5 0 0 0 0 3 3 3 0 0 1 0 0 0 0 5 6 6 6 6 1 0 0 0 0 0 3 3 3 0 0 0 0 0 5
5 0 0 0 0 3 3 3 0 2 0 0 0 0 0 4 4 4 4 5 0 0 1 0 0 0 0 0 0 0 0 0 0 0 5
5 0 0 0 0 0 0 0 0 0 0 0 0 0 3 3 0 0 0 5 0 0 0 0 0 0 0 0 0 0 0 3 0 0 5
5 0 0 0 0 0 0 0 0 0 0 0 0 0 0 0 0 0 0 5 2 0 0 0 0 0 0 0 0 0 3 3 3 0 5
4 4 4 4 4 4 4 4 4 4 4 4 4 4 4 4 4 4 4 4 4 4 4 4 4 4 1 1 1 4 4 4 4 4 4